time - Die Zeit
man - Der Mann
hand - Die Hand
day - Der Tag
way - Der Weg
eye - Das Auge
thing - Das Ding
head - Der Kopf
year - Das Jahr
room - Das Zimmer
door - Die Tür
woman - Die Frau
face - Das Gesicht
mother - Die Mutter
people - Das Volk
night - Die Nacht
house - Das Haus
father - Der Vater
life - Das Leben
back - Der Rücken
voice - Die Stimme
girl - Das Mädchen
place - Der Ort
boy - Der Junge
car - Das Auto
side - Die Seite
arm - Der Arm
child - Das Kind
word - Das Wort
moment - Der Moment
hair - Das Haar
foot - Der Fuß
water - Das Wasser
light - Das Licht
world - Die Welt
name - Der Name
friend - Der Freund
window - Das Fenster
body - Der Körper
table - Der Tisch
morning - Der Morgen
bed - Das Bett
wall - Die Mauer
street - Die Straße
school - Die Schule
air - Die Luft
floor - Der Boden
hour - Die Stunde
end - Das Ende
family - Die Familie
guy - Der Kerl
kind - Die Art
minute - Die Minute
story - Die Geschichte
god - Der Gott
week - Die Woche
work - Die Arbeit
shoulder - Die Schulter
part - Der Teil
mind - Der Geist
book - Das Buch
finger - Der Finger
mouth - Der Mund
kid - Das Kind
glass - Das Glas
tree - Der Baum
sound - Der Klang
line - Die Linie
wife - Die Ehefrau
heart - Das Herz
money - Das Geld
phone - Das Telefon
look - Das Aussehen
leg - Das Bein
chair - Der Stuhl
office - Das Büro
brother - Der Bruder
question - Die Frage
city - Die Stadt
month - Der Monat
baby - Das Baby
home - Das Zuhause
dog - Der Hund
road - Die Straße
idea - Die Idee
kitchen - Die Küche
lot - Das Ganze
son - Der Sohn
job - Der Beruf
paper - Das Papier
sister - Die Schwester
smile - Das Lächeln
point - Der Punkt
thought - Der Gedanke
love - Die Liebe
town - Die Stadt
death - Der Tod
ground - Der Boden
others - Die Anderen
fire - Das Feuer
step - Der Schritt
blood - Das Blut
fact - Die Tatsache
breath - Der Atem
lip - Die Lippe
sun - Die Sonne
building - Das Gebäude
number - Die Anzahl
husband - Der Ehemann
parent - Das Elternteil
corner - Die Ecke
problem - Das Problem
couple - Das Ehepaar
daughter - Die Tochter
bag - Der Beutel
hell - Die Hölle
rest - Die Rast
business - Das Geschäft
sky - Der Himmel
box - Die Kiste
person - Die Person
reason - Der Grund
right - Das Recht
skin - Die Haut
dad - Der Vater
case - Der Fall
piece - Das Stück
doctor - Der Doktor
edge - Die Ecke
mom - Die Mama
picture - Das Bild
sense - Der Sinn
ear - Das Ohr
second - Der Zweite
lady - Die Dame
neck - Der Hals
wind - Der Wind
desk - Der Schreibtisch
gun - Die Waffe
stone - Der Stein
coffee - Der Kaffee
ship - Das Schiff
earth - Die Erde
food - Das Essen
horse - Das Pferd
field - Das Feld
war - Der Krieg
afternoon - Der Nachmittag
sir - Die Sir
space - Der Raum
evening - Der Abend
letter - Der Brief
bar - Die Bar
dream - Der Traum
apartment - Die Wohnung
chest - Die Brust
game - Das Spiel
summer - Der Sommer
matter - Der Grund
silence - Die Stille
top - Die Spitze
rock - Der Fels
power - Die Macht
clothes - Die Kleider
sign - Das Schild
attention - Die Aufmerksamkeit
music - Die Musik
state - Der Staat
pocket - Die Tasche
dinner - Das Abendessen
hall - Die Halle
pain - Der Schmerz
age - Das Alter
river - Der Fluss
chance - Die Chance
nose - Die Nase
shadow - Der Schatten
police - Die Polizei
memory - Das Gedächtnis
color - Die Farbe
knee - Das Knie
wood - Das Holz
shirt - Das Hemd
party - Die Party
country - Das Land
truck - Der Lkw
tooth - Der Zahn
bill - Die Rechnung
scene - Die Szene
land - Das Land
star - Der Stern
bird - Der Vogel
bedroom - Das Schlafzimmer
uncle - Der Onkel
sort - Die Art
group - Die Gruppe
truth - Die Wahrheit
trouble - Die Schwierigkeiten
crowd - Die Menge
station - Der Bahnhof
tear - Die Reiß
class - Die Klasse
sea - Das Meer
animal - Das Tier
center - Das Zentrum
feeling - Das Gefühl
store - Das Geschäft
mountain - Der Berg
news - Die Nachrichten
shoe - Der Schuh
cat - Die Katze
screen - Der Bildschirm
bottle - Die Flasche
call - Der Anruf
living - Die Lebenden
cheek - Die Wange
student - Der Schüler
ball - Der Ball
sight - Die Sehenswürdigkeit
hill - Der Hügel
company - Das Unternehmen
church - Die Kirche
rain - Der Regen
suit - Der Anzug
one - Der Eine
direction - Die Richtung
will - Der Wille
throat - Der Hals
middle - Die Mitte
answer - Die Antwort
stuff - Das Zeug
hospital - Das Krankenhaus
camera - Die Kamera
dress - Das Kleid
card - Die Karte
yard - Der Hof
dark - Die Dunkelheit
shit - Die Scheiße
image - Das Bild
machine - Die Maschine
distance - Die Distanz
area - Das Gebiet
narrator - Der Erzähler
ice - Das Eis
snow - Der Schnee
note - Die Notiz
mirror - Der Spiegel
king - Der König
fear - Die Angst
officer - Der Offizier
hole - Das Loch
shot - Der Schuss
guard - Der Wächter
conversation - Die Unterhaltung
boat - Das Boot
system - Das System
care - Die Pflege
bit - Die Bit
movie - Der Film
bone - Der Knochen
page - Die Seite
captain - Der Kapitän
aunt - Die Tante
control - Die Kontrolle
drink - Das Getränk
hotel - Das Hotel
coat - Der Mantel
stair - Die Treppen
order - Die Bestellung
rose - Die Rose
miss - Der Fehl
hat - Der Hut
gold - Das Gold
cigarette - Die Zigarette
cloud - Die Wolke
view - Die Aussicht
driver - Der Fahrer
cup - Die Tasse
figure - Die Figur
expression - Der Ausdruck
path - Der Pfad
key - Der Schlüssel
computer - Der Computer
flower - Die Blume
ring - Der Ring
bathroom - Das Bad
metal - Das Metall
moon - Der Mond
song - Das Lied
soldier - Der Soldat
radio - Das Radio
history - Die Geschichte
wave - Die Welle
plan - Der Plan
college - Das College
fish - Der Fisch
garden - Der Garten
train - Der Zug
shop - Das Geschäft
cop - Der Polizist
art - Die Kunst
beer - Das Bier
north - Der Nord
island - Die Insel
bus - Der Bus
smell - Der Geruch
noise - Das Geräusch
mama - Die Mama
park - Der Park
south - Der Süden
pair - Das Paar
lord - Der Herr
plate - Der Teller
jacket - Die Jacke
help - Die Hilfe
daddy - Der Papa
grass - Das Gras
thanks - Die Dank
heat - Die Hitze
sleep - Der Schlaf
brain - Das Gehirn
service - Der Service
trip - Die Reise
beat - Der Beat
knife - Das Messer
spot - Der Platz
message - Die Nachricht
mark - Die Note
teacher - Der Lehrer
gaze - Der Blick
village - Das Dorf
winter - Der Winter
front - Die Front
law - Das Gesetz
surface - Die Oberfläche
bank - Die Bank
team - Das Team
maximum - Das Maximum
position - Die Position
stomach - Der Bauch
turn - Die Wende
west - Der Westen
lunch - Das Mittagessen
change - Der Wechsel
creature - Die Kreatur
soul - Die Seele
leaf - Das Blatt
show - Die Show
gate - Die Gate
palm - Die Palme
plastic - Der Kunststoff
force - Die Kraft
beach - Der Strand
president - Der Präsident
shape - Die Form
smoke - Der Rauch
wheel - Das Rad
silver - Das Silber
roof - Das Dach
weight - Das Gewicht
tongue - Die Zunge
tea - Der Tee
track - Die Strecke
angle - Der Winkel
form - Die Form
tone - Der Ton
circle - Der Kreis
spring - Der Frühling
porch - Die Vorhalle
sheet - Das Blatt
member - Das Mitglied
pool - Das Schwimmbecken
need - Das Bedürfnis
hope - Die Hoffnung
lake - Der See
breast - Die Brust
surprise - Die Überraschung
interest - Die Interesse
bottom - Der Boden
spirit - Der Geist
block - Der Block
language - Die Sprache
bridge - Die Brücke
dust - Der Staub
cell - Die Zelle
wine - Der Wein
boot - Das Boot
choice - Die Wahl
row - Die Reihe
talk - Das Gespräch
plane - Das Flugzeug
watch - Die Uhr
information - Die Information
grandmother - Die Großmutter
wing - Der Flügel
bob - Die Bob
club - Der Club
master - Der Meister
grace - Die Gnade
forest - Der Wald
size - Die Größe
set - Der Satz
marriage - Die Ehe
forehead - Die Stirn
storm - Der Sturm
doorway - Die Türöffnung
situation - Die Situation
counter - Der Zähler
neighbor - Der Nachbar
photo - Das Foto
stage - Die Bühne
meeting - Das Treffen
nurse - Die Krankenschwester
security - Die Sicherheit
weapon - Die Waffe
event - Das Ereignis
ceiling - Die Decke
engine - Der Motor
gift - Das Geschenk
restaurant - Das Restaurant
board - Die Tafel
hallway - Der Flur
army - Die Armee
effort - Der Aufwand
east - Der Osten
agent - Der Agent
future - Die Zukunft
pant - Die Hose
leather - Das Leder
flight - Der Flug
sex - Das Geschlecht
court - Das Gericht
course - Der Kurs
dirt - Der Dreck
egg - Das Ei
chin - Das Kinn
stranger - Der Fremde
pleasure - Die Freude
detail - Das Detail
crew - Die Besatzung
fall - Der Herbst
guest - Der Gast
experience - Das Erlebnis
joke - Der Witz
sand - Der Sand
fist - Die Faust
action - Die Aktion
walk - Das Wandern
wedding - Die Hochzeit
deal - Der Deal
nature - Die Natur
planet - Der Planet
cousin - Der Cousin
movement - Die Bewegung
flesh - Das Fleisch
record - Der Datensatz
camp - Das Camp
newspaper - Die Zeitung
ray - Der Strahl
human - Der Mensch
couch - Das Sofa
motion - Die Bewegung
grandfather - Der Großvater
photograph - Die Fotografie
secret - Das Geheimnis
beauty - Die Schönheit
presence - Das Vorhandensein
bell - Die Glocke
folk - Die Volks
button - Der Knopf
list - Die Liste
level - Das Level
date - Das Datum
subject - Das Thema
difference - Der Unterschied
pause - Die Pause
van - Der Van
blade - Die Klinge
television - Das Fernsehen
cover - Die Titelseite
past - Die Vergangenheit
farm - Der Bauernhof
lap - Die Runden
band - Die Band
lawyer - Der Anwalt
magazine - Das Magazin
branch - Der Ast
frame - Der Rahmen
deck - Das Deck
effect - Der Effekt
dance - Der Tanz
vision - Die Sicht
ghost - Das Gespenst
ass - Der Esel
character - Der Charakter
glance - Der Blick
goodbye - Das Auf Wiedersehen
parking - Das Park
breakfast - Das Frühstück
gesture - Die Geste
luck - Das Glück
blanket - Die Decke
gas - Das Gas
corridor - Der Korridor
professor - Der Professor
play - Das Spiel
mistake - Der Fehler
university - Die Universität
ocean - Der Ozean
century - Das Jahrhundert
honey - Der Honig
pile - Der Stapel
bowl - Die Schale
fence - Der Zaun
rule - Die Regel
laughter - Das Gelächter
anger - Die Wut
sweat - Der Schweiß
accident - Der Unfall
weather - Das Wetter
decision - Die Entscheidung
angel - Der Engel
strength - Die Stärke
chicken - Das Huhn
study - Die Studium
tape - Das Band
wrist - Das Handgelenk
stop - Der Halt
hip - Die Hüfte
government - Die Regierung
belly - Der Bauch
queen - Die Königin
tail - Der Schweif
plant - Die Pflanze
flame - Die Flamme
heaven - Der Himmel
belt - Der Gürtel
neighborhood - Die Nachbarschaft
energy - Die Energie
green - Das Grün
quarter - Das Viertel
enemy - Der Feind
move - Die Bewegung
entrance - Der Eingang
library - Die Bibliothek
writer - Der Verfasser
peace - Der Frieden
touch - Die Berührung
pot - Der Topf
type - Der Typ
cause - Der Grund
rope - Das Seil
muscle - Der Muskel
painting - Das Gemälde
curtain - Die Gardine
meal - Die Mahlzeit
act - Der Akt
wolf - Der Wolf
cabin - Die Kajüte
charge - Die Ladung
clock - Die Uhr
passenger - Der Passagier
buddy - Der Kumpel
drug - Das Medikament
use - Die Verwendung
bench - Die Bank
traffic - Der Verkehr
relief - Das Relief
cap - Die Kappe
pack - Das Rudel
weekend - Das Wochenende
stand - Der Stand
elevator - Der Aufzug
birthday - Der Geburtstag
iron - Das Bügeleisen
meat - Das Fleisch
eyebrow - Die Augenbraue
response - Die Antwort
speed - Die Geschwindigkeit
purpose - Die Absicht
skirt - Der Rock
square - Das Quadrat
drive - Die Fahrt
article - Den Artikel
english - Das Englisch
tower - Der Turm
battle - Der Kampf
film - Der Film
race - Das Rennen
shock - Der Schock
section - Die Sektion
manner - Die Methode
sword - Das Schwert
stick - Der Stock
file - Die Datei
bread - Das Brot
oil - Das Öl
chain - Die Kette
department - Die Abteilung
project - Das Projekt
murder - Der Mord
bear - Der Bär
test - Der Test
visit - Der Besuch
milk - Die Milch
boss - Der Chef
elbow - Der Ellbogen
desire - Das Verlangen
patient - Der Patient
grin - Das Grinsen
lover - Der Liebhaber
price - Der Preis
map - Die Karte
knowledge - Das Wissen
beginning - Der Anfang
cold - Die Kälte
closet - Der Schrank
dawn - Die Morgendämmerung
temple - Der Tempel
joy - Der Spaß
duty - Die Pflicht
practice - Die Übung
heel - Die Ferse
valley - Das Tal
fight - Der Kampf
wire - Das Kabel
jeans - Die Jeans
kiss - Der Kuss
jaw - Der Kiefer
run - Die Lauf
hold - Der Halt
relationship - Das Verhältnis
object - Das Objekt
attack - Der Angriff
dish - Das Gericht
highway - Die Autobahn
shade - Die Schattierung
crime - Das Verbrechen
white - Das Weiß
partner - Der Partner
priest - Der Priester
lawn - Der Rasen
laugh - Das Lachen
trunk - Der Kofferraum
cry - Das Weinen
program - Das Programm
ride - Die Fahrt
shelf - Das Regal
gentleman - Der Gentleman
being - Das Sein
steel - Der Stahl
sidewalk - Der Bürgersteig
uniform - Die Uniform
pattern - Das Muster
evidence - Der Beweis
player - Der Spieler
novel - Der Roman
pillow - Das Kissen
lamp - Die Lampe
drawer - Die Schublade
danger - Die Gefahr
detective - Der Detektiv
instant - Die Instant
thinking - Das Denken
crack - Der Riss
prayer - Das Gebet
towel - Das Handtuch
glove - Der Handschuh
bay - Die Bucht
audience - Das Publikum
can - Die Dose
condition - Die Bedingung
trail - Der Pfad
waist - Die Taille
pressure - Der Druck
telephone - Das Telefon
sink - Das Waschbecken
return - Die Rückkehr
breeze - Die Brise
taste - Der Geschmack
fault - Der Fehler
stream - Der Strom
result - Das Ergebnis
author - Der Autor
tip - Das Trinkgeld
shower - Die Dusche
toe - Die Zehe
season - Die Jahreszeit
half - Die Hälfte
fool - Der Dummkopf
tunnel - Der Tunnel
client - Der Klient
garage - Die Garage
mission - Die Mission
chief - Der Chef
bullet - Die Kugel
market - Der Markt
loss - Der Verlust
series - Die Reihe
pen - Der Stift
term - Der Begriff
poem - Das Gedicht
prince - Der Prinz
clay - Der Ton
lock - Das Schloss
reality - Die Realität
snake - Die Schlange
apple - Der Apfel
mask - Die Maske
customer - Dem Kunden
birth - Die Geburt
break - Die Pause
wonder - Das Wunder
sunlight - Das Sonnenlicht
tank - Der Panzer
staff - Das Personal
lie - Die Lüge
faith - Der Glaube
honor - Die Ehre
cream - Die Creme
sake - Das Wohl
victim - Das Opfer
possibility - Die Möglichkeit
contact - Der Kontakt
mood - Die Stimmung
thumb - Der Daumen
reading - Das Lesen
fun - Der Spaß
candle - Die Kerze
cave - Die Höhle
post - Die Post
prison - Das Gefängnis
emotion - Die Emotion
leader - Der Führer
degree - Der Grad
feature - Die Eigenschaft
ticket - Das Ticket
alien - Das Alien
lesson - Der Unterricht
desert - Die Wüste
cut - Der Schnitt
mess - Die Unordnung
warning - Die Warnung
tale - Das Märchen
funeral - Das Begräbnis
cab - Das Taxi
reporter - Der Reporter
present - Das Geschenk
theater - Das Theater
length - Die Länge
mud - Der Schlamm
science - Die Wissenschaft
drop - Der Fall
string - Die Schnur
speech - Die Rede
copy - Die Kopie
cow - Die Kuh
worker - Der Arbeiter
thigh - Der Oberschenkel
lab - Das Labor
roll - Die Rolle
fruit - Das Obst
patch - Der Patch
silk - Die Seide
buck - Der Buck
brick - Die Ziegel
rifle - Das Gewehr
career - Die Karriere
issue - Das Thema
opportunity - Die Gelegenheit
director - Der Direktor
monster - Das Monster
vehicle - Das Fahrzeug
alley - Die Gasse
sleeve - Die Hülse
grave - Das Grab
bush - Der Busch
dining - Der Speisesaal
opening - Die Eröffnung
twin - Der Zwilling
barn - Die Scheune
pound - Das Pfund
site - Der Standort
flash - Der Blitz
judge - Der Richter
mass - Die Masse
process - Der Prozess
tie - Das Band
purse - Der Geldbeutel
pipe - Das Rohr
dragon - Der Drache
horizon - Der Horizont
tray - Die Schale
envelope - Der Umschlag
check - Die Prüfung
adult - Die Erwachsene
emergency - Der Notfall
material - Das Material
childhood - Die Kindheit
habit - Die Angewohnheit
artist - Der Künstler
address - Die Adresse
scent - Der Duft
universe - Das Universum
nod - Das Kopfnicken
shell - Die Muschel
community - Die Gemeinde
start - Der Anfang
wound - Die Wunde
mouse - Die Maus
pilot - Der Pilot
grade - Die Klasse
video - Das Video
basket - Der Korb
wagon - Der Wagen
attempt - Der Versuch
sofa - Das Sofa
cake - Der Kuchen
fellow - Der Kerl
affair - Die Affäre
shore - Die Küste
general - Die Allgemeine
root - Der Ursprung
robe - Die Robe
concern - Die Sorge
press - Die Presse
rat - Die Ratte
society - Die Gesellschaft
style - Der Stil
county - Die Kreis
command - Der Befehl
visitor - Der Besucher
model - Das Model
chamber - Die Kammer
beast - Das Biest
bunch - Das Bündel
background - Der Hintergrund
unit - Die Einheit
furniture - Die Möbel
nail - Der Nagel
scream - Der Schrei
property - Die Eigenschaft
equipment - Die Ausrüstung
driveway - Die Auffahrt
grip - Der Griff
tube - Das Rohr
ash - Die Asche
fan - Der Fan
opinion - Die Meinung
data - Die Daten
connection - Die Verbindung
trick - Der Trick
mystery - Das Mysterium
period - Die Periode
writing - Das Schreiben
horror - Der Horror
candy - Die Süßigkeit
bitch - Die Bitch
health - Die Gesundheit
manager - Der Geschäftsführer
safety - Die Sicherheit
height - Die Höhe
appearance - Die Erscheinung
sigh - Der Seufzer
mine - Die Mine
cloth - Die Kleidung
reaction - Die Reaktion
source - Die Quelle
self - Das Ich
pistol - Die Pistole
airport - Der Flughafen
hero - Der Held
promise - Das Versprechen
bow - Der Bogen
tent - Das Zelt
booth - Der Messestand
cash - Das Geld
avenue - Die Straße
tshirt - Das TShirt
carpet - Der Teppich
basement - Der Keller
girlfriend - Die Freundin
beard - Der Bart
brow - Die Stirn
display - Der Bildschirm
signal - Das Signal
servant - Der Diener
whisper - Das Flüstern
doubt - Der Zweifel
account - Das Konto
magic - Die Magie
hank - Die Hank
limb - Das Glied
bastard - Der Bastard
skull - Der Schädel
sentence - Der Satz
collar - Der Kragen
horn - Das Horn
oak - Die Eiche
ankle - Der Knöchel
doll - Die Puppe
sandwich - Das Sandwich
robin - Das Rotkehlchen
justice - Die Justiz
pride - Der Stolz
youth - Die Jugend
secretary - Der Sekretär
research - Die Forschung
sport - Der Sport
task - Die Aufgabe
grant - Der Zuschuss
sheriff - Der Sheriff
midnight - Die Mitternachts
chip - Der Chip
theory - Die Theorie
alarm - Den Wecker
collection - Die Sammlung
cross - Das Kreuz
pine - Die Kiefer
generation - Die Generation
authority - Die Autorität
papa - Die Papa
journey - Die Reise
pearl - Die Perle
toilet - Die Toilette
killer - Der Mörder
tool - Das Werkzeug
medicine - Die Medizin
sugar - Der Zucker
princess - Die Prinzessin
argument - Das Argument
cliff - Die Klippe
cart - Der Wagen
crystal - Der Kristall
bean - Die Bohne
cage - Der Käfig
chocolate - Die Schokolade
coast - Die Küste
decade - Das Jahrzehnt
meaning - Die Bedeutung
gear - Das Getriebe
suitcase - Der Koffer
operation - Die Operation
breathing - Das Atem
role - Die Rolle
version - Die Version
prisoner - Der Gefangene
match - Das Match
beam - Der Strahl
castle - Die Burg
rush - Der Ansturm
lane - Die Fahrspur
clothing - Die Bekleidung
pole - Der Pol
freedom - Die Freiheit
skill - Das Können
passion - Die Leidenschaft
activity - Die Aktivität
fuck - Zum Teufel
platform - Die Platform
salt - Das Salz
bike - Das Fahrrad
stack - Der Stapel
companion - Der Begleiter
fate - Das Schicksal
rage - Die Wut
supply - Die Versorgung
whale - Der Wal
pig - Das Schwein
rabbit - Der Hase
aisle - Der Gang
monitor - Der Bildschirm
helmet - Der Helm
respect - Der Respekt
excitement - Die Aufregung
lobby - Die Lobby
boyfriend - Der Freund
fur - Das Fell
range - Der Bereich
dick - Die Dick
code - Der Code
chapter - Das Kapitel
reflection - Die Reflexion
mail - Die Post
fly - Der Flug
cabinet - Das Kabinett
toy - Das Spielzeug
baseball - Die Baseball
inside - Das Innere
pace - Die Geschwindigkeit
handle - Der Griff
lead - Die Führung
amount - Die Summe
nerve - Der Nerv
terror - Der Schrecken
sweater - Der Pullover
quality - Die Qualität
hunter - Der Jäger
paint - Die Farbe
buster - Die Buster
cotton - Die Baumwolle
sergeant - Der Wachtmeister
credit - Der Kredit
blow - Der Schlag
devil - Der Teufel
threat - Die Bedrohung
success - Der Erfolg
eve - Dem Vorabend
cable - Das Kabel
pan - Die Pfanne
clerk - Der Angestellte
title - Den Titel
meter - Das Messgerät
shame - Die Schande
needle - Die Nadel
lung - Die Lunge
warrior - Der Krieger
circumstance - Der Umstand
studio - Das Studio
panic - Die Panik
lack - Der Mangel
farmer - Der Bauer
accent - Der Akzent
bomb - Die Bombe
panel - Die Platte
ability - Die Fähigkeit
fortune - Das Glück
victor - Der Sieger
feather - Die Feder
grandma - Die Oma
glow - Das Glühen
behavior - Das Verhalten
passage - Der Durchgang
slave - Die Slave
lieutenant - Der Leutnant
barrel - Der Lauf
warmth - Die Wärme
impression - Der Eindruck
mason - Der Maurer
bride - Die Braut
package - Das Paket
fog - Der Nebel
walking - Das Gehen
balance - Die Balance
sock - Die Socke
robot - Der Roboter
potato - Die Kartoffel
item - Der Gegenstand
bath - Das Bad
diamond - Der Diamant
corpse - Die Leiche
explanation - Die Erklärung
structure - Die Struktur
exit - Der Ausgang
pad - Das Pad
stove - Der Herd
blue - Das Blaue
american - Die Amerikaner
ruby - Der Rubin
lightning - Der Blitz
pit - Die Grube
colonel - Der Oberst
dock - Das Dock
creek - Der Bach
advice - Der Ratschlag
tourist - Der Tourist
grief - Die Trauer
defense - Die Verteidigung
bite - Der Biss
museum - Das Museum
favor - Die Gunst
supper - Das Abendessen
comfort - Der Komfort
dean - Der Dekan
value - Der Wert
march - Der Marsch
estate - Das Anwesen
poet - Der Poet
palace - Der Palast
soup - Die Suppe
nation - Die Nation
jar - Das Gefäss
standing - Der Ständige
sack - Der Sack
demon - Der Dämon
conference - Die Konferenz
juice - Der Saft
responsibility - Die Verantwortung
brush - Der Pinsel
route - Die Route
cheese - Der Käse
hood - Die Haube
duck - Die Ente
saint - Der Heilige
pass - Der Pass
target - Das Ziel
orange - Die Orange
culture - Die Kultur
tour - Die Reise
commander - Der Kommandant
hook - Der Haken
mist - Der Nebel
training - Das Training
search - Die Suche
coin - Die Münze
miracle - Das Wunder
advantage - Der Vorteil
exchange - Der Austausch
fiction - Die Fiktion
pond - Der Teich
assistant - Der Assistent
design - Das Design
fishing - Die Angel
slope - Die Piste
earl - Der Graf
comment - Der Kommentar
waiter - Der Kellner
grocery - Der Lebensmittel
ladder - Die Leiter
curve - Die Kurve
volume - Das Volumen
risk - Das Risiko
nightmare - Der Albtraum
existence - Die Existenz
trace - Die Spur
disease - Die Krankheit
support - Die Unterstützung
witness - Der Zeuge
stock - Die Aktie
device - Das Gerät
landscape - Die Landschaft
holiday - Der Urlaub
ace - Das Ass
piano - Das Klavier
gut - Die Eingeweide
talent - Das Talent
imagination - Die Phantasie
black - Die Schwarze
reed - Der Reed
lid - Der Deckel
hint - Der Hinweis
walker - Der Wanderer
chill - Die Kälte
trial - Die Studie
interview - Das Interview
approach - Der Ansatz
scar - Die Narbe
fashion - Die Mode
channel - Der Kanal
footstep - Die Tritt
pickup - Der Aufnehmer
hawk - Der Habicht
trailer - Der Anhänger
statue - Die Statue
pill - Die Pille
bug - Der Käfer
bucket - Der Eimer
vacation - Den Urlaub
species - Die Arten
column - Die Kolumne
damage - Der Schaden
instrument - Das Instrument
port - Der Hafen
layer - Die Schicht
strip - Der Streifen
garbage - Der Müll
rib - Die Rippe
notebook - Das Notebook
corn - Der Mais
offer - Das Angebot
drawing - Die Zeichnung
statement - Die Aussage
intelligence - Die Intelligenz
excuse - Die Entschuldigung
landing - Die Landung
copyright - Der Urheberrechts
rod - Die Stange
fantasy - Die Fantasie
curiosity - Die Neugier
gown - Das Kleid
border - Die Grenze
poetry - Die Poesie
firm - Die Firma
rise - Der Aufgang
handful - Die Handvoll
china - Die China
french - Die Franzosen
mean - Die Durchschnitts
deer - Das Reh
print - Die Druck
rail - Die Schiene
rate - Die Rate
courage - Der Mut
arrival - Die Ankunft
wish - Der Wunsch
ridge - Der Grat
idiot - Der Idiot
bull - Der Bulle
seed - Die Saat
progress - Der Fortschritt
feel - Das Gefühl
shorts - Die Shorts
citizen - Der Bürger
trash - Der Müll
log - Das Protokoll
patience - Die Geduld
bat - Die Fledermaus
football - Der Fußball
routine - Die Routine
explosion - Die Explosion
content - Der Inhalt
scientist - Der Wissenschaftler
failure - Das Versagen
sin - Die Sünde
butt - Der Hintern
confusion - Die Verwirrung
understanding - Das Verständnis
trade - Der Handel
refrigerator - Der Kühlschrank
mister - Der Herr
flashlight - Die Taschenlampe
net - Das Internet
sailor - Der Seemann
attitude - Die Attitüde
guilt - Die Schuld
crying - Das Weinen
sip - Die Sip
travel - Die Reise
cookie - Der Keks
escape - Die Flucht
instruction - Die Anleitung
fabric - Das Gewebe
marble - Der Marmor
glimpse - Der Blick
dusk - Die Dämmerung
cottage - Die Hütte
monkey - Der Affe
makeup - Das Makeup
doc - Die Doc
blouse - Die Bluse
rhythm - Der Rhythmus
steam - Der Dampf
phrase - Der Satz
nut - Die Mutter
pencil - Der Bleistift
cook - Der Koch
flag - Die Flagge
coach - Der Trainer
swing - Die Schaukel
speaker - Der Lautsprecher
bolt - Der Bolzen
fat - Das Fett
rug - Der Teppich
knock - Die Klopf
spell - Der Zauber
taxi - Das Taxi
round - Die Runde
straw - Der Strohhalm
hatch - Die Luke
fork - Die Gabel
evil - Das Böse
maid - Das Dienstmädchen
relative - Die Relative
witch - Die Hexe
courtyard - Der Hof
sensation - Die Sensation
bubble - Die Blase
reader - Der Leser
curl - Die Locke
pie - Der Kuchen
jet - Der Strahl
shift - Die Verschiebung
union - Die Union
teenager - Der Teenager
plain - Die Ebene
waitress - Die Kellnerin
reply - Die Antwort
rumor - Das Gerücht
gravity - Die Schwerkraft
shelter - Die Zuflucht
adventure - Das Abenteuer
lion - Der Löwe
spine - Die Wirbelsäule
confidence - Das Vertrauen
depth - Die Tiefe
reach - Die Reichweite
hammer - Der Hammer
bible - Die Bibel
contract - Der Vertrag
wallet - Der Geldbeutel
jungle - Der Dschungel
factory - Die Fabrik
indian - Die Indische
balcony - Der Balkon
rice - Der Reis
knot - Der Knoten
cord - Die Schnur
colleague - Der Kollege
intention - Die Absicht
stare - Die Stare
motel - Das Motel
attorney - Der Anwalt
darling - Der Liebling
discussion - Die Diskussion
performance - Die Leistung
tension - Die Spannung
text - Der Text
strand - Der Strang
noon - Die Mittags
vein - Die Vene
expert - Der Experte
gang - Die Gruppe
policeman - Der Polizist
cancer - Der Krebs
fox - Der Fuchs
divorce - Die Scheidung
pulse - Die Impuls
absence - Die Abwesenheit
violence - Die Gewalt
humor - Der Humor
stool - Der Stuhl
gravel - Der Kies
treasure - Der Schatz
butter - Die Butter
switch - Der Schalter
cigar - Die Zigarre
canvas - Die Leinwand
happiness - Die Fröhlichkeit
guide - Der Führer
pin - Der Stift
actor - Der Schauspieler
whole - Das Ganze
arrangement - Die Vereinbarung
brown - Die Braune
host - Der Gastgeber
ribbon - Das Farbband
scarf - Der Schal
scale - Die Skala
proof - Der Beweis
arrow - Der Pfeil
temperature - Die Temperatur
technology - Die Technologie
permission - Die Erlaubnis
location - Der Ort
claw - Die Klaue
cowboy - Der Cowboy
agency - Die Agentur
construction - Die Konstruktion
hunting - Das Jagd
vegetable - Das Gemüse
tin - Die Dose
helicopter - Der Hubschrauber
trap - Die Falle
pat - Das Pat
gap - Die Lücke
pet - Das Haustier
education - Die Bildung
shopping - Das Einkaufen
shed - Der Schuppen
agreement - Die Vereinbarung
soil - Die Erde
duke - Der Herzog
shotgun - Die Schrotflinte
notion - Die Vorstellung
rear - Die Rück
ceremony - Die Zeremonie
spoon - Der Löffel
tub - Die Wanne
clue - Der Schlüssel
iris - Die Iris
incident - Der Vorfall
crash - Der Absturz
journal - Das Tagebuch
access - Die Zugriffs
brass - Der Messing
mommy - Die Mama
sidebar - Die Seitenleiste
sheep - Das Schaf
engineer - Der Ingenieur
hull - Der Rumpf
odor - Der Geruch
appointment - Der Termin
invitation - Die Einladung
rag - Die Lappen
good - Das Gute
dude - Der Kumpel
treatment - Die Behandlung
wisdom - Die Weisheit
prize - Der Preis
element - Das Element
giant - Der Gigant
napkin - Die Serviette
laundry - Die Wäsche
option - Die Option
rack - Das Regal
request - Die Anforderung
jail - Das Gefängnis
grandpa - Der Opa
ranch - Die Ranch
dot - Der Punkt
script - Das Skript
mall - Die Einkaufshalle
ford - Der Ford
exercise - Die Übung
widow - Die Witwe
crow - Die Krähe
thread - Der Faden
suicide - Die Selbstmord
notice - Die Notiz
sunset - Der Sonnenuntergang
gallery - Die Gallerie
vessel - Das Schiff
thunder - Der Donner
soap - Die Seife
whiskey - Der Whisky
female - Das Weibchen
mayor - Der Bürgermeister
stroke - Der Hub
click - Der Klick
reputation - Der Ruf
miller - Der Müller
council - Der Rat
schedule - Der Stundenplan
cemetery - Der Friedhof
struggle - Der Kampf
instinct - Der Instinkt
calm - Die Ruhe
employee - Der Arbeitnehmer
nest - Das Nest
limit - Das Limit
german - Der Deutsche
monk - Der Mönch
worm - Der Wurm
document - Das Dokument
sadness - Die Traurigkeit
hut - Die Hütte
lifetime - Die Lebensdauer
dancer - Die Tänzerin
insurance - Die Versicherung
difficulty - Die Schwierigkeit
mattress - Die Matratze
male - Der Mann
clinic - Die Klinik
ad - Die Ad
mug - Der Becher
kit - Das Kit
communication - Die Kommunikation
disaster - Das Unglück
tile - Die Fliese
receiver - Der Empfänger
roar - Das Gebrüll
troop - Die Truppe
coffin - Der Sarg
friendship - Die Freundschaft
investigation - Die Ermittlung
sale - Der Verkauf
goal - Das Ziel
ambulance - Der Krankenwagen
moonlight - Das Mondlicht
ward - Das Mündel
trousers - Die Hosen
wool - Die Wolle
mac - Die Mac
minister - Der Minister
entry - Der Eintritt
thief - Der Dieb
briefcase - Die Aktentasche
pity - Das Mitleid
fingertip - Die Finger
navy - Die Marine
insect - Das Insekt
velvet - Der Samt
bee - Die Biene
cane - Der Stock
gene - Das Gen
salad - Der Salat
windshield - Die Windschutzscheibe
outfit - Das Outfit
shuttle - Der Shuttle
shout - Der Schrei
fury - Die Wut
challenge - Die Herausforderung
satisfaction - Die Zufriedenheit
motor - Der Motor
product - Das Produkt
weed - Das Unkraut
stretch - Die Strecke
gym - Das Fitnesscenter
capital - Das Kapital
rim - Der Rand
paw - Die Pfote
fort - Die Festung
cost - Die Kosten
poster - Das Plakat
vampire - Der Vampir
shaft - Die Welle
identity - Die Identität
pavement - Der Bürgersteig
asshole - Das Arschloch
strap - Der Gurt
parlor - Das Wohnzimmer
harbor - Der Hafen
example - Das Beispiel
web - Das Netz
golf - Der Golf
crap - Den Mist
delight - Die Freude
quilt - Die Decke
tax - Die Steuer
fold - Die Falte
portrait - Das Porträt
tissue - Das Gewebe
belief - Der Glaube
costume - Das Kostüm
measure - Das Maß
carriage - Der Wagen
guitar - Die Gitarre
knight - Der Ritter
rank - Der Rang
major - Der Bürgermeister
fountain - Der Brunnen
stall - Der Stall
load - Die Ladung
spark - Der Funke
waste - Der Müll
champagne - Der Champagner
district - Das Viertel
protection - Der Schutz
judgment - Das Urteil
sympathy - Die Sympathie
violet - Das Violett
impact - Der Aufprall
disappointment - Die Enttäuschung
drinking - Das Trink
consciousness - Das Bewusstsein
handkerchief - Das Taschentuch
dancing - Das Tanzen
perfume - Das Parfüm
network - Das Netzwerk
claim - Der Anspruch
nun - Die Nonne
crown - Die Krone
railing - Das Geländer
license - Die Lizenz
mercy - Die Barmherzigkeit
balloon - Der Ballon
chaos - Das Chaos
fever - Das Fieber
locker - Das Schließfach
session - Die Sitzung
burst - Die Burst
peak - Der Spitzer
drum - Die Trommel
focus - Der Fokus
frog - Der Frosch
benefit - Der Vorteil
remark - Die Bemerkung
tide - Die Gezeiten
suspicion - Der Verdacht
jeep - Der Jeep
worry - Die Sorge
literature - Die Literatur
archer - Der Bogenschütze
household - Der Haushalt
powder - Das Pulver
shepherd - Der Hirte
lens - Die Linse
favorite - Der Favorit
madame - Die Madame
mansion - Die Villa
boom - Der Boom
lace - Die Spitze
review - Die Überprüfung
reception - Die Rezeption
scrap - Der Schrott
bead - Der Wulst
glare - Die Blendung
flow - Die Strömung
cafe - Das Cafe
status - Der Status
pounding - Das Pochen
rocket - Die Rakete
canyon - Die Schlucht
sorrow - Die Trauer
spider - Die Spinne
blast - Die Explosion
personality - Die Persönlichkeit
campus - Der Campus
curse - Der Fluch
staircase - Das Treppenhaus
urge - Der Drang
frustration - Die Frustration
pump - Die Pumpe
ease - Die Leichtigkeit
count - Die Zählung
solution - Die Lösung
jewelry - Der Schmuck
siren - Die Sirene
hit - Der Schlag
tradition - Die Tradition
curb - Das Leer
variety - Die Vielfalt
pirate - Der Pirat
description - Die Beschreibung
dear - Der Liebe
anxiety - Die Angst
pitch - Die Tonhöhe
pizza - Die Pizza
elephant - Der Elefant
politics - Die Politik
tennis - Der Tennis
hunger - Der Hunger
genius - Das Genie
goat - Die Ziege
victory - Der Sieg
combination - Die Kombination
affiliation - Die Zugehörigkeit
momma - Das Momma
cape - Der Umhang
headlight - Der Scheinwerfer
governor - Der Gouverneur
oxygen - Die Sauerstoff
bishop - Der Bischof
bundle - Das Bündel
development - Die Entwicklung
fingernail - Der Fingernagel
score - Die Punktzahl
mate - Der Steuermann
rider - Der Fahrer
orbit - Die Umlaufbahn
vine - Der Weinstock
suite - Die Suite
bartender - Der Barkeeper
coke - Der Koks
tune - Die Melodie
glory - Die Herrlichkeit
rabbi - Der Rabbi
surgery - Die Operation
cattle - Das Vieh
ritual - Das Ritual
greeting - Die Begrüßung
slice - Die Scheibe
homer - Die Homer
fireplace - Der Kamin
jersey - Das Trikot
media - Die Medien
pop - Die Pop
cargo - Die Fracht
inn - Das Gasthaus
deputy - Der Stellvertretende
despair - Die Verzweiflung
territory - Das Territorium
punch - Der Schlag
jazz - Die Jazz
hug - Die Umarmung
whistle - Die Pfeife
humanity - Die Menschlichkeit
craft - Das Handwerk
daylight - Das Tageslicht
worth - Der Wert
slip - Der Slip
armor - Die Rüstung
backpack - Der Rucksack
suggestion - Der Vorschlag
den - Die Höhle
symbol - Das Symbol
colony - Die Kolonie
conclusion - Das Fazit
nostril - Das Nasenloch
spear - Der Speer
impulse - Der Impuls
tomato - Die Tomate
calf - Das Kalb
autumn - Der Herbst
discovery - Der Fund
classroom - Das Klassenzimmer
delivery - Die Lieferung
spray - Das Spray
liquid - Die Flüssigkeit
fuel - Die Kraftstoff
underwear - Die Unterwäsche
dome - Die Kuppel
population - Die Bevölkerung
affection - Die Neigung
religion - Die Religion
singer - Der Sänger
attendant - Der Begleiter
illusion - Die Illusion
link - Der Link
lounge - Das Wohnzimmer
interior - Der Innenraum
shrug - Die Achselzucken
zone - Die Zone
standard - Der Standard
coal - Die Kohlen
chase - Die Jagd
lump - Der Klumpen
charm - Der Charm
legend - Die Legende
consequence - Die Konsequenz
observation - Die Beobachtung
bicycle - Das Fahrrad
harm - Der Schaden
pay - Die Zahlung
prospect - Das Prospekt
subway - Die UBahn
sample - Das Muster
cherry - Die Kirsche
dealer - Der Händler
assignment - Die Zuordnung
hurry - Die Eile
mistress - Die Geliebte
mound - Der Hügel
nonsense - Der Unsinn
committee - Das Komitee
echo - Das Echo
slack - Der Durchhang
decker - Die Decker
warehouse - Das Warenhaus
bout - Der Kampf
toast - Der Toast
facility - Die Einrichtung
basketball - Der Basketball
mustache - Der Schnurrbart
senator - Der Senator
share - Das Teilen
eyelid - Das Augenlid
enthusiasm - Die Begeisterung
chunk - Die Chunk
turtle - Die Schildkröte
alcohol - Der Alkohol
gum - Die Gummi
turkey - Der Truthahn
preacher - Der Prediger
possession - Der Besitz
dolly - Der Dolly
linen - Das Leinen
apology - Die Entschuldigung
lecture - Der Vortrag
boulder - Der Stein
heap - Der Heap
photographer - Der Fotograf
brake - Die Bremse
demand - Die Nachfrage
apron - Die Schürze
cloak - Der Mantel
jury - Die Jury
hearing - Die Anhörung
gray - Das Graue
crate - Die Kiste
method - Die Methode
reference - Die Referenz
disgust - Der Ekel
liquor - Die Flotte
lipstick - Der Lippenstift
core - Der Kern
individual - Der Einzelne
container - Der Container
whore - Die Hure
infant - Das Kleinkind
sunglasses - Die Sonnenbrille
hose - Der Schlauch
concert - Das Konzert
bullshit - Das Bullshit
railroad - Die Eisenbahn
parade - Die Parade
compartment - Das Fach
resident - Der Bewohner
oven - Der Backofen
technician - Der Techniker
procedure - Das Verfahren
fighter - Der Kämpfer
grain - Das Korn
picnic - Das Picknick
tribe - Der Stamm
bud - Die Knospe
meadow - Die Wiese
public - Die Öffentlichkeit
poison - Das Gift
buffalo - Der Büffel
region - Die Region
production - Die Produktion
running - Das Rennen
loop - Die Schleife
sleeping - Der Schlaf
soda - Die Soda
owl - Die Eule
menu - Das Menü
kick - Der Kick
ruin - Die Ruine
ramp - Die Rampe
streak - Der Streifen
forearm - Der Unterarm
bureau - Das Büro
knuckle - Der Achsschenkel
goose - Die Gans
advance - Der Vormarsch
fairy - Die Fee
illness - Die Krankheit
squad - Die Mannschaft
official - Das Offizielle
brand - Die Marke
organ - Die Orgel
butterfly - Der Schmetterling
empire - Das Reich
profile - Das Profil
liberty - Die Freiheit
disbelief - Der Unglaube
grove - Der Hain
shield - Das Schild
saddle - Der Sattel
odds - Die Chancen
cluster - Die Cluster
satellite - Der Satellit
trigger - Der Abzug
puppy - Der Welpe
waiting - Die Warte
bulb - Die Glühbirne
dresser - Die Kommode
patrol - Die Patrouille
eagle - Der Adler
privacy - Der Privatsphäre
fluid - Das Fluid
herd - Die Herde
headache - Der Kopfschmerz
amusement - Der Vergnügungspark
wheelchair - Der Rollstuhl
policy - Die Richtlinie
belle - Das Belle
tobacco - Die Tabak
setting - Die Einstellung
tattoo - Die Tätowierung
burden - Die Last
merchant - Der Händler
slide - Die Rutsche
stain - Der Fleck
eating - Das Essen
bond - Die Bindung
swimming - Das Schwimmen
foundation - Die Grundlage
injury - Die Verletzung
league - Die Liga
battery - Die Batterie
umbrella - Der Regenschirm
emperor - Der Kaiser
pier - Der Pier
tap - Der Wasserhahn
wit - Der Witz
cutter - Der Cutter
attic - Der Dachboden
tiger - Der Tiger
pal - Die Pal
ancestor - Der Vorfahr
concentration - Die Konzentration
mount - Der Berg
expense - Der Aufwand
blessing - Der Segen
leave - Der Urlaub
ledge - Die Leiste
torch - Die Fackel
ink - Die Tinten
plot - Die Handlung
rent - Die Miete
mule - Das Maultier
arch - Der Bogen
environment - Die Umgebung
frown - Das Stirnrunzeln
inspector - Der Inspektor
midst - Die Mitten
embarrassment - Die Verlegenheit
complaint - Die Beschwerde
portion - Die Portion
chuck - Das Spannfutter
clearing - Die Clearing
crisis - Die Krise
necklace - Die Halskette
lantern - Die Laterne
wealth - Der Reichtum
murderer - Der Mörder
civilization - Die Zivilisation
concept - Das Konzept
lamb - Das Lamm
stride - Die Schritt
cuff - Die Manschette
virgin - Die Jungfrau
squirrel - Das Eichhörnchen
babe - Das Kind
starling - Der Star
depression - Die Depression
storage - Das Speicher
altar - Der Altar
tragedy - Die Tragödie
resource - Die Ressource
traveler - Der Reisende
trust - Das Vertrauen
arc - Die Bogen
kingdom - Das Königreich
jewel - Das Juwel
musician - Der Musiker
airplane - Das Flugzeug
junk - Die Junk
sunshine - Der Sonnenschein
lad - Der Knabe
elf - Der Elf
protest - Der Protest
hunt - Die Jagd
executive - Die Exekutive
diary - Das Tagebuch
aspect - Das Aspekt
dial - Das Zifferblatt
slipper - Der Hausschuh
actress - Die Schauspielerin
shooting - Das Shooting
earring - Der Ohrring
ant - Die Ameise
patty - Die Patty
sauce - Die Sauce
missile - Die Rakete
intensity - Die Intensität
ditch - Der Graben
daisy - Das Gänseblümchen
chapel - Die Kapelle
swamp - Der Sumpf
relation - Die Beziehung
guess - Die Vermutung
crane - Der Kran
encounter - Die Begegnung
sequence - Die Sequenz
fragment - Das Fragment
draft - Der Entwurf
diner - Das Diner
function - Die Funktion
organization - Die Organisation
skeleton - Das Skelett
misery - Das Elend
herb - Das Kraut
stump - Der Stumpf
stake - Der Einsatz
puff - Die Puff
creation - Die Kreation
wake - Das Gefolge
wizard - Der Zauberer
mat - Die Matte
seal - Die Dichtung
twilight - Das Zwielicht
grunt - Das Grunzen
punishment - Die Strafe
clan - Der Clan
copper - Das Kupfer
debris - Die Trümmer
painter - Der Maler
steering - Das Steuer
math - Die Mathematik
recognition - Die Erkennung
temper - Die Stimmung
regret - Das Bedauern
destination - Das Ziel
mill - Die Mühle
error - Der Fehler
romance - Die Romantik
topic - Das Thema
patio - Die Terrasse
shovel - Die Schaufel
pajamas - Die Schlafanzüge
email - Die Email
pigeon - Die Taube
dinosaur - Der Dinosaurier
industry - Die Branche
operator - Der Betreiber
lift - Der Lift
counselor - Der Ratgeber
gathering - Die Versammlung
principle - Das Prinzip
drama - Das Drama
chick - Das Küken
chart - Das Diagramm
campaign - Die Kampagne
laurel - Der Lorbeer
steak - Das Steak
criminal - Der Kriminelle
globe - Der Globus
bruise - Der Bluterguss
knob - Der Knopf
killing - Das Töten
sweetheart - Der Schatz
opera - Die Oper
frost - Der Frost
nipple - Der Nippel
reverend - Der Pfarrer
haze - Die Trübung
flood - Das Hochwasser
carol - Das Weihnachtslied
weakness - Die Schwäche
cooking - Das Kochen
butcher - Der Metzger
cube - Der Würfel