dole - abajo
izvan - fuera
prosle subote - sabado pasado
juce - ayer
putovanje - viaje
pesma - cancion
svinja - cerdo
dalje - lejos
sinoc - anoche
niko - nadie

imas pravo - tienes razon
brinuti - preocupar
izgledas zauzeto - te ves preocupado
izabrati - elegir
siromasan - pobre
ogroman - gran
plakati - llorar
bio je tako mlad - era tan joven
reklama - anuncio
tvrd - duro

recenica - oracion
smesan - gracioso
vruce - caluroso
drvo - arbol
kisa - lluvia
napolje - afuera
nece biti - no va a haber
nastaviti - seguir
zeleo bih - querria
buka - ruido

iskljuciti - apagar
slupati - estrellar
duh - fantasma
umreti - morir


zaustaviti - parar
primer - ejemplo
odgovoriti - responder
lagati - mentir
noge - piernas
cuti - oir
biznis - negocio
seda kosa - canas
usta - boca
na vrhu - encima
buditi se - despertar

ne cujem te - no te oigo
nos - nariz
noga - pierna
zavrsiti - acabar
ruka - brazo
sanjati - sonar
brada - barba
ljubicasta - morado
mrzeti - odiar
ici u krevet - acostarse
ni ti - tu tampoco
dostupan - disponible

sastanak - reunion
kompanija - empresa
zato - asi
polomiti - romper
smejati se - se rier
suma - bosque
kolacic - galleta
djak - alumno
fin - amable
rekli smo da necemo koristiti - dijimos que no ibamos

priroda - naturaleza
peceni krompiri - patatas asadas
pun - lleno
zdrav - saludable
led - hielo
odlicno - estupendo
sala - broma
strana - lado
zavese - cortinas
svitanje - amancer

skinuti - quitar
pauza - descanso
spektakl - espectáculo
predstava - obra
mozda - a lo mejor
jezero - lago
motor - motocicleta
na zalost - desafortunadamente
biciklizam - ciclismo
setiti se - acuerdarse

firma - empresa
krv - sangre
baciti - tirar
tokom - durante
prodati - vender
smece - basura
tokom - durante
igracka - juguete
crkva - iglesia

mrsav - delgado
koleno - rodilla
bole me ledja - me duele la espalda
znak - senal
borba - pelea
dvoriste - patio
pridruziti se - acompanar
ponoc - medianoche
podne - mediodia
prestacu - voy a dejar
