mracan - oscuro
pada sneg - nieva
pada kisa - llueve
mesec - mes
despacio - sporo
slatko - dulce
obe - ambas
kesa - bolsa
debeo - gordo
rec - palabra

manje - menos
tanak - delgado
nositi - llevar
staviti - pones
vruce - caliente
stici - llegar
neki - algun
jaja - huevos
pronto - uskoro
sesenta - sezdeset

isto dobar kao - tan bueno como
tacno sada - ahora mismo
kljuc - llave
lice - carra
prelepa - bella
kosa - cabello
cetkica za zube - cepillo de dientes
tvoj - tuyo
film - pelicula
doneti - traer

plakati - llorar
ucionica - aula
upravo citam - estoy leyendo
vec - ya
sporo - lento
svetao - ligero
nastaviti - seguir
kazati - decir
voziti - manejar
skrenuti - girar

stici - llegar
losije - peor
datum - fecha
ostati - quedar
sledeci - que viene
doci - venir
promeniti - cambiar
naravno - por supuesto
misliti - pensar
