moci - poder
ispod - debajo
videti - ver
kosulja - camisa
znati - saber
solja - taza
casa - vaso
secer - azucar
sladoled - helado
bez - sin

nula - cero
jedan - uno
dva - dos
tri - tres
cetiri - cuatro
pet - cinco
sest - seis
sedam - siete
osam - ocho
devet - nueve
deset - diez

ona vidi - ella mira
ljubicasto - morado
nesto - algo
naocare za sunce - gafas de sol
oni su za tebe - Son para ti
kuvati - cocinar
zabavno - divertido
povrce - vegetales
zeleznicka stanica - estación de tren
odmor - vacaciones

uzbudjen - eomocionado
kada su - Cuando son
nedelja - semana
svaki dan - todos los dias
test - examen
moram da ucim - tengo que estudiar
ranac - mochila
kako - como
dosadan - aburrido
salter - mostrador

zeleo bih da budem - quisiera estar
pored - al lado de
sediste - asiento
mozete li mi pomoci - puede ayudarme
kosa - pelo
plesati - bailar
nazvati - llamar
ne jos - no todavia
zajedno - juntos
pirinac - arroz

pasulj - frijoles
ko - Quien
isto - mismos
sta da radim - Que hago
roditelji - padres
cetristo - cuatrociento
trinaest - trece
sta radis - Que haces
otici - salir
drzava - pais

koliko kosta - Cuanto cuesta
davati - dar
otvori - abrelo
smesno - gracioso
zaboraviti - olvidar
mozes mi dati - puedes darme
nauciti - aprender
ustati - levantar
strah - miedo
verovati - creer

sa mnom - conmigo
vratiti se - vuelver
posle - despues
dnevna soba - sala
cesto - menudo
zadovoljan - contento
ptica - pajaro
vecera - cena
kuhinja - cocina
dolaziti - venir

torta - pastel
sledeci - proximo
vecerati - cenar
vezba - ejercicio
poslednji - ultimo
sprat - piso
basta - jardin
osecati - sienter
ne osecam se - no me siento
dvadeset - veinte
moje cvece - mis flores
sastanak - cita

ponedeljak - lunes
utorak - martes
sreda - miercoles
cetvrtak - jueves
petak - viernes
subota - sabado
nedelja - domingo

radionica - taller
vreme rucka - hora del almuerzo
krompiri - patatas
dugacak - largo
zdrav - saludable
uzmi - toma
onda - entonces
cistiti - limpiar
prati - lavar
prozor - ventana