devojka - niña
gde su - Donde estan
kljucevi - llaves
ici - ir
posao - trabajo
ovde - aqui
sto - mesa
ja sam - estoy
umoran - cansado
zeleti - querer

piti - beber
ovo je - eso es
stvar - cosa
u - en
njegov - su
unuka - nineta
idi u - vas al
iz - del
sok - jugo
imati - tener

takodje - tambien
sastati - conoser
samo - solo
cura - novia
brat - hermano
deda - abuelo
dobrodosao - bienvenida
danas - hoy
mec - partido
igrati - jugar

i ja isto - yo tambien
odakle si - de donde eres
setati - caminar
radnja - tienda
odeca - ropa
skup - caro
obozavam - me encanta
kupiti - comprar
rodjendan - cumpleaños
najbolji - mejor

poklon - regalo
jeftin - barato
tasna - cartera
trcati - correr
traziti - buscar
med - miel
karta - boleto
grad - ciudad
muz - esposo

tezak - dificil
tuzan - tristo
zao mi je - lo siento
uzivati - disfruter
pricati - hablar
pomoc - ayuda
oko - cerca
bolestan - enfermo
nov - nuevo
radite - usted trabaja

kaput - abrigo
platiti - pagar
ne znam - yo no se
postoji - hay
nas - nuestro
ime - nombre
pisati - escribir
visok - alto
cipele - zapatos
iza - detras

razred - clase
pitanje - pregunta
zauzet - ocupado
zaista - de verdad
ne idem - no voy
skola - escuela
lako - facil
uzeti - tomar
ponovo - otra vez
otvoriti - abrir

vrata - puerta
citati - leer
hrana - comida
pile - pollo
sir - queso
prostor - espacio
mi - nosotros
ovaj - este
previse - demasiado
malen - pequeño

stolica - silla
haljina - vestido
zeleno - verde
braon - marron
plavo - azul
sivo - gris
spreman - listo
sad - ahora
dvadesetpet - veinticinco
glad - hambre
