tih - silencio
mozes sesti - puedes sentarte
portret - retrato
slikati - pintar
glava - cabeza
tako - tan
nos - nariz
mozete li me uslikati - puede tomarme una foto
socijalne mreze - redes sociales
kasno - tarde

dobro izgledam - me veo bien
ispred - enfrente
pedeset - cincuenta
vezbati - practicar
sport - deporte
lopta - pelotas
plivati - nadar
raditi - hacer
poceti - empenzar
prestani plesati - para de bailar

domaci - tarea
star - viejo
oko - sobre
zakasniti - llegar tarde
dobiti - llegar
codan - extrano
frizider - nevera
prljav - sucio
cimerka - compañera de cuarto
raspravljati - discutir

iznenadjen - sorprendida
tvoj - tuyo
ljut - furioso
ponekad - a veces
daleko - lejos
desno - derecha
levo - izquierda
mlad - joven
koristiti - usar
