harder - más duro, más difícil
sometimes - a veces
weather here is very warm - el tiempo aquí es muy cálido
bakery - panadería
local government - ayuntamiento
firefighter - bombero
to pray - rezar
chances - oportunidades
bookstore - librería
to ask for, to order - pedir

do you usually go to the gym? - normalmente vas al gimnasio?
flight - vuelo
company - compañía
the best - el mejor
the worst - el peor
haircut - corte de pelo
cheap - barato
to attend - asistir
north - norte
south - sur

east - este
west - oeste
season - estación, temporada
Winter - invierno
Spring - primavera
Summer - verano
Fall - otoño
cider - sidra
to usually do - soler
do you usually watch television? - sueles ver la televisión?
tale - cuento
fable - fábula
story - historia
science - ciencia
