calentar - to heat
despertar - to wake up
mentir - to lie
perder - to lose
contar - to count
volver - to return
medir - to measure
reír - to laugh
despedir - to fire
impedir - to prevent

vestir - to dress
valer - to be worth
caer - to fall
construir - to build
sustituir - to replace
incluir - to include
atribuir - to attribute
desvestirse - to undress
por supuesto - of course
poner - to put

vale la pena - it's worth it
bajar - to go down
subir - to go up
lejos - far away
cerca - close
en cambio - on the other hand
lavadora - washing machine
aprobar - to pass
desde aquí - from here
puente - bridge

edificio - building
déjalo ir - let it go
pisada - footstep
pie - foot
paso - step
suelo - floor
cállate - shut up
ruidos extraños - weird noises
hace mucho calor - it's very hot
boda - wedding

pantalla - screen
aburrido - boring
le ayuda - he helps him
afeitarse - to shave
acostarse - to go to sleep
llegar - to arrive
montar - to ride
cuál de ellos? - which one?
at this moment - en este momento
congratulations - felicidades

to suffer - sufrir
to understand - entender
retirement - jubilación
couple - pareja
that much - tanto
to turn into - volverse
how are you - cómo lo llevas
to carry - llevar
to have a feeling = presentir
to finish - terminar

to sign up - apuntarse
all the same = me da igual
day after tomorrow - pasado mañana
day before yesterday - anteayer
silver - plata
gold - oro
by the way - oye

just in case - por si acaso
in fact - de hecho
neighbourhood - vecindario
amazing - increíble
me quedaré con - I will meet
shape - forma
in addition - además
to park - aparcar
to drive - conducir
subjects - asignaturas
I ask myself - me pregunto
lagoon - lago
