equality - die Gleichberechtigung
experience - die Erfahrung
to support - unterstützen
mutual - gegenseitig
to argue - streiten
relationship - das Verhältnis
to rely on - sich verlassen
single parenting - alleinerziehend
after school care center - der Hort
to take care of - erledigen
upbringing - die Erziehung
cheerful - munter
divorce - die Scheidung
care - die Betreuung
age of marriage - das Heiratsalter

to compare - vergleichen
to distinguish - sich unterscheiden
to complain - sich beklagen
law - das Gesetz
company - der Betrieb
employed - berufstätig
rule - die Regel
working man - der Berufstätige
during - während
interrupted - unterbrochen
approximately - ungefähr
sufficient - reicht
however indeed - allerdings
on the other hand - andererseits
due to - wegen
within - innerhalb
outside of - außerhalb


employment - die Erwerbstätigkeit
day care - die Tagesbetreuung
dishwasher - der Geschirrspüler
to load - einräumen
to unload - ausräumen
to hang up - aufhängen
to take down - abnehmen
to take away - wegbringen
to iron - bügeln
to vacuum - staubsaugen
to rest - sich ausruhen
to tidy up - aufräumen
society - die Gesellschaft
to exchange - tauschen
namely - nämlich
to remove - entfernen
it seems to me - mir scheint
application - die Bewerbung
even - sogar

female - weiblich
to agree - zustimmen
authorization - die Berechtigung
sights - die Sehenswürdigkeiten
business trip - die Geschäftsreise
having a cold - verkühlt
exhausting - anstrengend
right now - gerade echt
small thing - die Kleinigkeit
to open - aufmachen
stupid - blöd
victim - das Opfer

exactly - genauso
tight - enges
to feel - fühlen
media usage - die Mediennutzung
further education - die Fortbildung
