to subscribe - abonnieren
several times - mehrmals
to grow up - aufwachsen
constantly - ständig
to tie - knüpfen
simultaneously - gleichzeitig
one third - das Drittel
teenagers - die Jugendlichen
to handle - umzugehen
on the way - unterwegs
busy - verabredet

selection - die Auswahl
toy - die Spielware
advice - die Beratung
naturally - selbstverständlich
to turn off - ausschalten
certainly - bestimmt
more popular - beliebter
increased - gestiegen
meanwhile - inzwischen
more frequently - häufiger
rated - bewertet
the product - die Ware
to touch - anfassen
above all - Vor allem
agreed - einverstanden
to confirm - bestätigen
to add - hinzufügen
return policy - Rückgaberecht
retraining - Umschulung