skladiste - Lager
odeljenje - Abteilung
uprava - Geschäftsführung
odgovoran - verantwortlich
zatvaranje - Schließung
boriti se - kämpfen
predstavnik - Vertreter
administracija - Verwaltung
zahtevati - fordern
pretiti - drohen
pregovor - Verhandlung
bezuspesan - erfolglos
profitabilan - rentabel
sluzbenik - Angestellte
zaposleni - Beschäftigte
dogovor - Einigung
poslovni dogovor - Betriebsvereinbarung
zastita od otkaza - Kündigungsschutz
dati otkaz - kündigen
porez - Steuer
profesionalno iskusan - berufserfahren
zaposlen - tätig
vladati - beherrschen
mogucnost napretka - Aufstiegsmöglichkeit
biznis - Betrieb
korisnicki servis - Kundendienst
sistem - Anlage
kopija sertifikata - Zeugniskopie
profesionalna karijera - Berufliche Werdegang
razvijati se - sich entwickeln
tokom - während
racun - Abrechnung
obracun plate - Gehaltsabrechnung
porezki razred - Steuerklasse
bruto plata - Bruttogehalt
dedukcija - Abzug
porez na prihod - Lohnsteuer
prihod - Einkommen
zasluga - Verdienst
prosecan - durchschnittlich
opste - allgemein
putnik - Pendler
klatno - Pendel
doprinos - Beitrag
odbici - Abzüge
tekuci mesec - laufender Monat
iznos - Betrag
priloziti aplikaciju - einen Antrag stellen
preduzece - Unternehmen
