zbog toga - deswegen
oporavljen - genesen
vakcinisan - geimpft
testiran - getestet
sara aplicira - sara bewirbt sich
nismo mogli - wir konnten nicht
nebismo mogli - wir könnten nicht
jedan nemac - einen Deutschen
od - von den
oglas - die Anzeige
iskusan - erfahren
nedostajati - fehlen
uslov - die Voraussetzung
sposoban - fähig
sposobnost - die Fähigkeit
plata - das Gehalt
napredovanje - der Aufstieg
zavrsene studije - ein abgeschlossenes Studium
briga oko nekoga - die Betreuung
obrada - die Bearbeitung
priprema - die Vorbereitung
osobine - die Eigenschaften
timski - teamfähig
samostalan - selbstständig
dinamican - dynamisch
razuman - vernünftig
strpljiv - geduldig
odgovarajuci - geeignet
pregovor - die Verhandlung
osobina - die Eigenschaft
nada - Hoffnung
biti zaposlen - tätig sein
radost - die Freude
biti naviknut - gewohnt sein
vladati necim - etwas beherrschen
izmedju ostalog - unter anderem
prilog - die Anlage
zaposlenost - die Tätigkeit
razvijati se - sich entwickeln
razvoj - die Entwicklung
radovati se oko - sich freuen über