dopusteno - erlaubt
list - das Blatt
autoput - die Autobahn
navoditi - lenken
upozoriti - warnen
podizati - heben
krug prijatelja - Freundeskreis
tvrdjava - Festung
camac - das Boot
slican - ‰hnlich
sipati - gieﬂen
svedok - der Zeuge
pregledati - untersuchen
kreciti zidove - W‰nde streichen
praviti setnju - einen Spaziergang machen
ici setati - spazieren gehen
kao da sam ja - als ob ich
kao da sam u sumi - als ob ich in einem Wald w‰re
deljen stan - die Wohngemeinschaft
dopusteno - erlaubt
upozorenje - die Warnung
posetiti - besichtigen
padati - fallen
ispasti - ausfallen
airline - die Fluggesellschaft
snabdeti - versorgen
dete - Bub
pesak - der Fuﬂg‰nger
otkazano - gestrichen
steta - der Schaden
proceniti - sch‰tzen