paziti na - achten auf
pricati o - erzählen über
brinuti se o - sich kümmern um
interesovati se za - sich interessieren für
cekati na - warten auf
zaliti se na - sich beschweren über
radovati se oko - sich freuen auf/über
aplicirati na - sich bewerben bei um
radi se o necemu - es geht um etwas
ucestvovati u - teilnehmen an
misliti na - denken an
razmisljati o - nachdenken über
verujem u tebe - ich glaube an dich
mislim na tebe - ich denke an dich
imati zelju raditi nesto - Lust auf etwas haben
o cemu se ovde radi - Worum geht es hier
radi se o - Es geht um
smejati se necemu - lachen über etwas
pitam za put - ich frage nach dem Weg
zavisiti od - abhängen von
on ucestvuje u - er nimmt daran teil
pomoci oko - helfen bei
razmisliti o - nachdenken über
diskutovati o - diskutieren über
pricati o - sprechen über
znati o - wissen über
misliti na - denken an
brinuti o - aufpassen auf
propustiti - verpassen
nedostajes mi - ich vermisse dich
