asocijacija roditelja - der Elternverein
izbeglica - der Flüchtling
prevoditi - übersetzen
parlament - der Landtag
parlament - das Parlament
sastoji se od - bestehen (aus)
izbor - die Wahl
partija - die Partei
opozicija - die Opposition
vlada - die Regierung
poslanik - der Abgeordnete
kancelar - der Bundeskanzler
upravljati - regieren
odrediti - bestimmen
savezni predsednik - der Bundespräsident
zastupati - repräsentieren

savezno vece - der Bundesrat
zakon - das Gesetz
za sada - zurzeit
mir - der Frieden
nezaposlenost - die Arbeitslosigkeit
kriminal - die Kriminalität
zanemarivanje - vernachlässigen
okupirati - beschäftigen (sich) (mit)

obrazovanje odraslih - die Erwachsenenbildung
ogranicenje brzine - die Geschwindigkeitsbeschränkung
omladinski centar - das Jugendzentrum
otvor - die Eröffnung
profit - der Gewinn
promena - die Änderung
peomeniti - ändern
industrijska zona - das Industriegebiet
do sad - bisher
transportno preduzece - der Verkehrsbetrieb
ulaznica - die Eintrittskarte
profitirati - profitieren
kulturna ponuda - das Kulturangebot
mesto odrzavanja - der Veranstaltungsort
poboljsati - verbessern
cena karte - der Fahrpreis
smanjiti - senken
ponuda za slobodno vreme - das Freizeitangebot

