rukovodeca pozicija - die Führungsposition
izazov - die Herausforderung
definitivno - bestimmt
imigraciona zemlja - das Einwanderungsland
mozda - eventuell
imigraciona pozadina - der Migrationshintergrund
verovatno - wohl
raznovrsno - vielfältig
predavac - der Dozent
sadasnjost - die Gegenwart

nivo - die Stufe
raditi test - einen Test ablegen
ocekivati - erwarten
prilika - die Gelegenheit
nesigurnost - die Unsicherheit
demografija - die Bevölkerungsentwicklung
nestati - verschwinden
stanovnistvo - die Einwohnerzahl
naci se - zurecht finden
imigracija - die Zuwanderung

bivsi - ehemalig
imigrant - der Zuwanderer
preporuka - die Empfehlung
zbogom - der Abschied
pretpostavlja se da - Man geht davon aus, dass...
penzija - der Ruhestand
ekonomski - wirtschaftlich
stadijum zivota - der Lebensabschnitt
seoski - ländlich
svakodnevni rad - der Arbeitsalltag
ruralno podrucje - ländlicher Raum
dalje - weiterhin

zamisli nesto - vor stellen (sich) (etwas)
za dobrobit - Zum Wohl
drzati - halten
izvestavati - melden
izgubiti smisao - an Bedeutung verlieren
pobrinuti se za - auf passen (auf)
oskudan - knapp
saberi se - zusammen ziehen
vredan - wertvoll
sadrzati - bewahren