der Start - start
der Inhaber - vlasnik
leiten - sprovesti
reichen - proslediti
hart - tesko
weiterempfehlen - preporuciti
die Verantwortung - odgovornost
Entscheidungen treffen - doneti odluku
sich selbstständig machen - postati samostalan
das Berufsleben - radni vek
der Existenzgründer - preduzetnik
die Unternehmensführung - rukovodstvo kompanije
Das Geschäft läuft gut - posao ide dobro
die Geschäftsidee - poslovna ideja
die Niederlassung - grana
schwerfallen - biti tesko
beschließen - odluciti
stolz - ponosno
ein Wunsch erfüllen - ispuniti zelju
kaum - jedva
entwickeln - razviti
lohnen sich - isplatilo se
ziemlich - poprilicno
inzwischen - u medjuvremenu
das Finanzamt - poresko
das Gewerbe - biznis
einrichten - namestiti
die Finanzierung - finansiranje
fachlich - profesionalni
die Branche - bransa
das Ziel - cilj
ein Ziel erreichen - postici cilj
entscheiden - odluciti
der Ratschlag - savet
auskennen - znati o
versuchen - pokusati
die Anregung - sugestija
die Dienstleistung - usluga
das Förderprogramm - program finansiranja
Finanzberater - finansijski savetnik
der Standort - lokacija
Lieferant - snabdevac
das Eigenkapital - kapital
Schulden - dugovi
die Unterlagen - dokumenta



