der Bach - potok
das Tal - uvala
das Gebirge - planina
die Landschaft - pejzaz
die Landwirtschaft - poljoprivreda
der Klimawandel - klimatske promene

Pflanzenarten - biljne vrste
heizen - zagrevanje
abschalten - iskljuciti

der Umweltschutz - zastita zivotne sredine
das Kohlekraftwerk - termo elektrana
der Rohstoff - sirovi materijal
Abgase - izduvni gasovi
verschmutzen - zagadjivanje

das Hochwasser - poplava
die Mülltrennung - odvajanje otpada
verschwenden - tracenje
gering - mala kolicina
Naturschutzgebiet - rezervat prirode

erneuerbar - obnovljivi
lebenswichtig - vitalni
sparsam - ekonomicni
die Kernenergie - nuklearna energija
der Atommüll - nuklearni otpad
schädlich - stetni

der Abfall - smece
die Müllentsorgung - odlaganje smeca
entsorgen - odbaciti
der Restmüll - ostalo smece
der Akku - baterija
