paziti na - achten auf
pricati o - erzählen über
brinuti se o - sich kümmern um
interesovati se za - sich interessieren für
cekati na - warten auf
zaliti se na - sich beschweren über
radovati se oko - sich freuen auf/über
aplicirati na - sich bewerben bei um
radi se o necemu - es geht um etwas
ucestvovati u - teilnehmen an
nista - nix
blizanci - Zwillinge
cuvati - zu bewahren
izgubiti nit - den Faden verlieren
misliti na - denken an
razmisljati o - nachdenken über
dugo sam razmisljao o tome - ich dachte so lange darüber nach
verujem u tebe - ich glaube an dich
mislim na tebe - ich denke an dich
imati zelju raditi nesto - Lust auf etwas haben
radi se o coveku - Es geht um einen Mann
o cemu se ovde radi - Worum geht es hier
radi se o - Es geht um
smejati se necemu - lachen über etwas
necim vladati - etwas beherrschen
ceniti - schätzen
porudzbina - der Auftrag
delimicno - zum Teil
najpre - zunächst
ulazak - der Einstieg
pre svega - vor allem
voditi - leiten
delovanje - die Wirkung
uskladiti se - sich vereinbaren