kruzovanje - die Kreuzfahrt
raznolikost - die Abwechslung
saopstenje - die Durchsage
izlaz - die Ausfahrt
traka - der Fahrstreifen
zatvoriti - sperren
obilaznica - die Umleitung
odpisati - ausschildern
predmet - der Gegenstand
autoput - die Fahrbahn
zeleznicki saobracaj - der Bahnverkehr
oprezan - vorsichtig
gepek - der Kofferraum
brisaci stakala - der Scheibenwischer
volan - das Lenkrad
kvacilo - die Kupplung
sigurnosni pojas - der Sicherheitsgurt
far - der Scheinwerfer
bocno ogledalo - der Seitenspiegel
trougao - das Pannendreieck
soferka - die windschutzscheibe
zmigavac - der Blinker
hauba - die Motorhaube
guma - der Reifen
kocnica - die Bremse
dizalica - der Wagenheber
menjac - der Schalthebel
nivo ulja - der Ölstand
svedok - der Zeuge
konsultovati - befragen
odvuci - abschleppen
preusmeriti - umleiten
povredjeni - die Verletzten

