gebacken - backen (to bake)
befohlen - befehlen1 (to order)
begonnen - beginnen (to begin)
gebissen - beiﬂen (to bite)
geborgen - bergen (to save)
geborsten - bersten (to burst)
gebogen - biegen (to bend)
geboten - bieten (to offer)
gebunden - binden (to bind)
gebeten - bitten (to ask)
geblasen - blasen (to blow)
geblieben - bleiben (to stay)
gebleicht - bleichen (to bleach)
gebraten - braten (to fry)
gebrochen - brechen (to break)
gedroschen - dreschen (to thresh)
gedrungen - dringen (to push)
empfohlen - empfehlen1 (to recommend)
erschrocken - erschrecken (to frighten)
erwogen - erw‰gen (to consider)
gegessen - essen (to eat)
gefahren - fahren (to drive)
gefallen - fallen (to travel)
gefangen - fangen (to fall)
gefochten - fechten (to catch)
gefunden - finden (to fence)
geflochten - flechten (to find)
geflogen - fliegen (to braid)
geflohen - fliehen (to fly)
geflossen - flieﬂen (to flee)
gefressen - fressen (to flow)
gefroren - frieren (to eat)
gegoren - g‰ren (to freeze)
geboren - geb‰ren (to ferment)
gegeben - geben (to give)
gediehen - gedeihen (to give)
gegangen - gehen (to flourish)
gelungen - gelingen (to go)
gegolten - gelten (to succeed)
genesen - genesen (to be)
genossen - genieﬂen (to count)
geschehen - geschehen (to recover)
gewonnen - gewinnen (to enjoy)
gegossen - gieﬂen (to happen)
geglichen - gleichen (to win)
geglitten - gleiten (to pour)
geglommen - glimmen (to be)
gegraben - graben (to glide)
gegriffen - greifen (to glow)
gehalten - halten (to dig)
gehangen - h‰ngen (to grab)
gehauen - hauen (to stop)
gehoben - heben (to hang)
geheiﬂen - heiﬂen (to hew)
geholfen - helfen (to hit)
geklommen - klimmen (to lift)
geklungen - klingen (to be)
gekniffen - kneifen (to help)
gekommen - kommen (to clamber)
gekrochen - kriechen (to sound)
geladen - laden (to pinch)
gelassen - lassen (to come)
gelaufen - laufen (to crawl)
gelitten - leiden (to load)
geliehen - leihen (to let)
gelesen - lesen (to run)
gelegen - liegen (to suffer)
gelogen - l¸gen (to lend)
gemahlen - mahlen (to borrow)
gemieden - meiden (to read)
gemolken - melken (to lie)
gemessen - messen (to lie)
misslungen - misslingen (to mill)
genommen - nehmen (to avoid)
gepfiffen - pfeifen (to milk)
gepriesen - preisen (to measure)
gequollen - quellen (to fail)
gerieten - raten (to miss)
gerieben - reiben (to take)
gerissen - reiﬂen (to whistle)
geritten - reiten (to praise)
gerochen - riechen (to well)
gerungen - ringen (to guess)
gerufen - rufen (to tear)
gesalzen - salzen (to snatch)
gesoffen - saufen (to ride)
gesogen - saugen (to smell)
geschaffen - schaffen (to wrestle)
geschallt - schallen (to run)
geschieden - scheiden (to call)
geschienen - scheinen (to salt)
geschissen - scheiﬂen (to drink)
geschoren - scheren2 (to suck)
geschoben - schieben (to create)
geschossen - schieﬂen (to resound)
geschunden - schinden (to separate)
geschlafen - schlafen (to shine)
geschlagen - schlagen (to seem)
geschlichen - schleichen (to shit)
geschliffen - schleifen3 (to shear)
geschlossen - schlieﬂen (to push)
geschlungen - schlingen (to shoot)
geschmissen - schmeiﬂen (to maltreat)
geschmolzen - schmelzen (to sleep)
geschnitten - schneiden (to hit)
geschrieben - schreiben (to slide)
geschrien - schreien (to grind)
geschritten - schreiten (to close)
geschwiegen - schweigen (to loop)
geschwommen - schwimmen (to throw)
geschwunden - schwinden (to melt)
geschwungen - schwingen (to cut)
geschworen - schwˆren (to write)
gesehen - sehen (to shout)
gesungen - singen (to step)
gesunken - sinken (to be)
gesonnen - sinnen (to swim)
gesessen - sitzen (to float)
gespalten - spalten (to fade)
gespien - speien (to swing)
gesponnen - spinnen (to swear)
gesprochen - sprechen (to see)
gesprossen - sprieﬂen (to sing)
gesprungen - springen (to sink)
gestochen - stechen (to think)
gestanden - stehen (to sit)
gestohlen - stehlen (to split)
gestiegen - steigen (to spit)
gestorben - sterben (to spin)
gestunken - stinken (to be)
gestoﬂen - stoﬂen (to speak)
gestrichen - streichen (to sprout)
gestritten - streiten (to jump)
getragen - tragen (to sting)
getroffen - treffen (to stand)
getrieben - treiben (to steal)
getreten - treten (to climb)
getrunken - trinken (to die)
getrogen - tr¸gen (to stink)
getan - tun (to push)
verdorben - verderben (to spread)
verdrossen - verdrieﬂen (to cancel)
vergessen - vergessen (to argue)
verloren - verlieren (to carry)
verschlissen - verschleiﬂen4 (to wear)
verziehen - verzeihen5 (to meet)
gewachsen - wachsen (to hit)
gewaschen - waschen (to drive)
gewoben - weben (to step)
gewichen - weichen (to drink)
gewiesen - weisen (to deceive)
geworben - werben (to do)
geworfen - werfen (to spoil)
gewogen - wiegen (to irk)
gewunden - winden (to forget)
gewrungen - wringen (to lose)
gezogen - ziehen (to wear)
gezwungen - zwingen (to forgive)